GENOMEFOLDER=genome
REFGENOME=genome/<<UPDATE WITH GENOME FILE NAME EXAMPLE: genome/FungiDB-39_AfumigatusAf293_Genome.fasta>>
GENOMENAME=<<SHORTHANDNAME EXAMPLE: Af293>>
SAMPFILE=samples.csv
FASTQFOLDER=input
FASTQEXT=fastq.gz
UNMAPPED=unmapped
UNMAPPEDASM=unmapped_asm
ASMEXT=fasta
ALNFOLDER=aln
ALNTOOL=bwa
HTCFOLDER=cram
HTCEXT=cram
HTCFORMAT=cram
TEMP=<<FIXME EXAMPLE: /scratch>>
GVCFFOLDER=gvcf
TREEDIR=strain_tree
RGCENTER=<<FIXME EXAMPLE: NCBI>>
RGPLATFORM=Illumina
GVCF_INTERVAL=1
FINALVCF=vcf
PREFIX=<<FIXME EXAMPLE: Afum_v1>>
REFNAME=<<FIXME EXAMPLE: Af293-REF>>
BQSRALN=bsqr
SLICEVCF=vcf_slice
SNPEFFOUT=snpEff
snpEffConfig=snpEff.config
SNPEFFGENOME=<<FIXME EXAMPLE: AfumigatusAf293_FungiDB_39>>
GFFGENOME=<<FIXME EXAMPLE: FungiDB-39_AfumigatusAf293.gff>>
POPYAML=population_sets.yaml
